11111
1_1_1
11B11
1_1_1
11111
---
Eat all carrots.
---
11111111111111111111
